##########
#I       #
# ###### #
#      # #
##########
#      #F#
##########
